3,3,3,3,3,0,0,0,0,0
3,1,0,0,3,0,0,0,0,0
3,0,2,2,3,0,3,3,3,0
3,0,2,0,3,0,3,4,3,0
3,3,3,0,3,3,3,4,3,0
0,3,3,0,0,0,0,4,3,0
0,3,0,0,0,3,0,0,3,0
0,3,0,0,0,3,3,3,3,0
0,3,3,3,3,3,0,0,0,0
0,0,0,0,0,0,0,0,0,0